yyyyyyyyyyyyyyyyyyyyyyyyyyyyyyyy
l                              r
l k                          k r
l                              r
l                              r
l                              r
l                              r
l                              r
l                              r
l                  lAr         r
l         f        l r         r 
l                  l r         r
###################l r########## 
#         #        l r         #
#                  l           #
#         #        ###         #
#         #          #         #
#         #          #         #
#         #          #         #
#         #          #         #
#   p     #                    #
################################
    
;
§diz
Crouch and walljump through the gaps to reach the finish!


§up
cell=A-2.0;0
size=6;6

§switch
cell=A
visible=0
toggle_script=A:active 0,player:rotate 2
