
#                           #
#                           #
#                           #
#                           #
#                           #
#    f                      #
#                           #
#                           #
#                           #
#                           #
#                           #
#                           #
#                ####       #
#                           #
#                           #
#                           #
#                           #
#                           #
#                  E        #
#                           #
#                           #
#                           #
#                           #
#                  ##       #
#                           #
#                           #
#                           #
#    ##                     #
#                           #
#                           #
#                           #
#                           #
#    D                      #
#                           #
#                           #
#                           #
#                           #
#                  ##       #
#                           #
#                           #
#    ##                     #
#                           #
#                  C        #
#                           #
#                           #
#                           #
#                           #
#                           #
#                  ##       #
#                           #
#                           #
#    ##                     #
#                           #
#                           #
#                           #
#                           #
#    B                      #
#                  ##       #
#                           #
#                           #
#                           #
#    ##                     #
#                           #
#                           #
#                  A        #
#                           #
#                  ##       #
#                           #
# p                         #
#############################
;
The finish is in the top left corner of this room.

§runner
cell=A
diry=1
size=6;18
gravity=0
speed=0.3

§runner
cell=B
diry=1
size=6;18
gravity=0
speed=0.3

§runner
cell=C
diry=1
size=6;18
gravity=0
speed=0.3

§runner
cell=D
diry=1
size=6;18
gravity=0
speed=0.3

§runner
cell=E
diry=1
size=6;18
gravity=0
speed=0.3

§end
