  #        #                                    
  #        #                                    
  #        #                                    
  #        #   #                     
  #        #  ###                                 
  #        # #####                                
  #   u    #   #                                  
  #        #   #                                  
  #        #                                      
  #        #####################                  
  #                            #                  
  #                   #        #                  
  #                  ###       #                  
  #                 #####      #                  
  #                   #        #                  
  #                   #        #                  
  #      bbbbbbbbbbbbbbbbbbbbbb#                  
  #      ##                    #                  
  #      ##                    #                  
  #      ##             C      #                  
  #      ##bbbbbbbbbbbbbbbbbbbb#                  
  #      ##                    #                  
  #      ##   B                #                  
  #      ##bbbbbbbb            #                  
  #      #####                 #                  
  #      ##                    #                  
  #s s s ##bbbbbbbbbbbbbbbbbbbb#                  
  #      ##                    #                  
  #      ##                A   #                  
  #      ##           bbbbbbbbb#                  
  #      ##                 ####                  
  #m m m ##                 bbb#                  
  #      ##  bbbbbbb           #                  
  #   f  ##                    #                  
  #      ##      p             #                  
  ##############################                  
                                                  
                                                  
;
§diz
This room introduces semi-permeable floors
and stompable blocks that you can crash through
at certain falling speeds.

While falling down, press DOWN to accelerate.

Blue blocks can be passed at average falling speeds.

Red blocks can only be crashed through at high 
falling speeds. 

§end

§runner
cell=A
dirx=-1
mover=0
size=2;8

§runner
cell=B
dirx=1
mover=0
size=2;8

§runner
cell=C
dirx=-1
mover=0
size=2;8
