                                                                                  
 ######################                                                           
 #                    #                                                           
 # kkkkkkkkkkkkkkkkk  #                                                           
 #                  k #                                                           
 #                  k #                                                           
 #                  k #                                                           
 #     u            k #                                                           
 #          k   f   k #                                                           
 ##          k     k  #                                                           
 ##           kkkkk   #                                                           
 ##                   #                                                           
 #k         ####k     #                                                           
 #          ####k     #                                                           
 #          ####k     #                                                           
 #          kkkkk     #                                                           
 #                    #                                                           
 #     yyyyyyyyyyyyyyy#                                                           
 #     kkkkkkkkkkkkkkk#                                                           
 #                    #                                                           
 #                    #                                                           
 #                    #                                                           
 #    p               #                                                           
 ######################                                                           
;
§diz
Spiky obstacles must be avoided at all costs.

Do not touch the red blocks and make your way
to the finish block !

§end

§challenge
message=Can you complete this room in under 3 seconds ?
time=3

