
                                                                                  
  #   # #### #    ##  ##  ## ## ####   ###  ##     #  #  # ## ## ###  #  #   ##   
  #   # #  # #   #   #  # # # # #  #    #  #  #     # #  # # # # #  # ####   ##   
  # # # ###  #   #   #  # #   # ###     #  #  #     # #  # #   # ###     #        
  ## ##  ###  ##  ##  ##  #   #  ###    #   ##    ##   ##  #   # #    ###    ##   
                                                                                  
##################################################################################
#                                                                           f f  #
# p                                                                         f f  #
#######       ###########        ##############              #####################
      #########          ########              ###           k                    
                                                  ###        k                    
                                                     kkk     k                    
                                                        kkk  k                    
                                                           kkk                    
;
§diz
Welcome to Jumpy !

Reach the green chequer on the right end to complete this room.

§end
