                                                                                          
                                                                                          
##########################################################################################
#                                                                                        #
#                                                                                        #
#                                                                                        #
#                                                                                        #
#                                                                                        #
#                                                                                        #
#                             #                                                          #
#                             #                                                          #
#                             #                                                          #
#                           #####                                                        #
#                            ###                                                         #
#   p                         #                                                          #
##############                                                                           #
                                                                                         #
                                                                                         #
                                            #                                            #
                                           ###                                           #
                                          #####                                          #
                                            #                                            #
                                            #                                            #
                                                                                         #
                                                                                         #
                                            F                                            #
                                                                                         #
                                                                                         #
                                        ##########                                       #
                                        ##########                                       #
;
§diz
Press UP while falling down to float for a short period of time.

§finish
cell=F-1.5;0

