                                                                                          
                                                                                          
##########################################################################################
#                                                                                        #
#                                                                                        #
#                                                                                        #
#                                                                               f        #
#                                                                                        #
#                                                                                        #
#              bbbbbbbbbbbbbbbb            bbbbbbbbbbbb             ######################
#                                                                                        #
#                                                                                        #
#                                                                                        #
#bbbbbbb                                                                                 #                             #########
#                                                                                        #                             #       #
#                                                                                        #                             #   B   #
#bbbbbbbbbbbbbbbbb                                                                       #                             #       #
#                                                                                        ###############################       #
#                                                                                        C                      A              #
#bbbbbbbbbbbbbbbbbbbbbbbbbbbb              #####################################################################################
#                                          #                                              
#                                          #                                              
#                                          #                                              
#                          bbbbbbbbbbbbbbbb#                                              
#                                          #                                              
#                                          #                                              
#            bbbbbbb                       #                                              
#                                          #                                              
#    p                                     #                                              
############################################                                              
;
§diz
Make your way to the finish by jumping across platforms. 
Hold UP to jump higher.


§runner
cell=A
dirx=1
size=1;6

§switch
cell=C
onlyrunners=1
visible=0
toggle_script=A:dirx 1

§finish
cell=B+0;-1.5
warp=a:rotate
