               ####################
               #                  #
               #                  #
               #                  #
               #             f    #
               #                  #
               #                  #
################          #########
#                         #
#         D       C       #        
#         R               #
#                         #
#                         #
#                         #                                              
#   p     A       B       #                                              
###########################                                              
;
§diz
Do not touch the block when it has turned red.
You can use it as an elevator when it is green.

Press UP to jump.

§runner
cell=R
gravity=0.0
size=6;6
dirx=0
diry=-1
turnaround=0
semipermeable=1

§switch
cell=A
visible=0
onlyrunners=1
toggle_script=R:dirx 1, R:diry 0

§switch
cell=B
visible=0
onlyrunners=1
toggle_script=R:dirx 0, R:diry 1

§switch
cell=C
visible=0
onlyrunners=1
toggle_script=R:dirx -1, R:diry 0

§switch
cell=D
visible=0
onlyrunners=1
toggle_script=R:dirx 0, R:diry -1

§sequencer
speed=64
step0=togglemover R,R:semipermeablex toggle
