#################################
#                               #
#                               #
#                               #
#                               #
# C                             #
#                               #
#                           u   #
#                               #
#                               #
#                               #
#         ################      #
#         #              #      #
#         #           D  #      #
#         #              #      #
#         #              #      #
#         #        #     #s s s #
#         #        #     #      #
#         #     u  #     #      #
#         #        #     #      #
#         #        #     #      #
#         #        #     #      #
#         #     u  #     #      #
#         #        #     #      #
#         #        #     #      #
#         #        #B    #      #
#         #     u  #            #
#         #        #            #
#         #        #            #
#         #        #            #
#         #     u  #            #
#         #        ##############
#         #        #            #
#         #        #            #
#A        #     u  #     f      #
#         #        #            #
#         #        #            #
#         #        #            #
#         #     u  #     u      #
#         #        #            #
#         #        #            #
#         #        #            #
#         #     u  #     u      #
#         #        #            #
#         #        #            #
#         #m m m m #            #
#       U #                     #
#         #                     #
#         #                     #
#Ep       #                     #
#################################
;
§diz
This room introduces stompable blocks that you can crash through
at certain falling speeds.

While falling down, press DOWN to accelerate.

Blue blocks can be passed at average falling speeds.

Red blocks can only be crashed through at high 
falling speeds. 

§runner
cell=A
size=15;2
diry=-1
dirx=0
gravity=0
speed=0.5
semipermeable=1

#
§up
cell=U-3;24*0
§up
cell=U-3;24*1
§up
cell=U-3;24*2
§up
cell=U-3;24*3
§up
cell=U-3;24*4
§up
cell=U-3;24*5
§up
cell=U-3;24*6
§up
cell=U-3;24*7
§up
cell=U-3;24*8

§runner
cell=B
size=15;2
diry=-1
dirx=0
gravity=0
speed=0.3
semipermeable=1

§switch
cell=C
onlyrunners=1
visible=0
toggle_script=A:diry invert

§switch
cell=E
onlyrunners=1
visible=0
toggle_script=A:diry invert

§switch
cell=D
onlyrunners=1
visible=0
toggle_script=B:diry invert

