r                                              l
r                                              l
r                                              l
r                                              l
r                                              l
r                                              l
r                                              l
r          B                                   l
r                                              l
r       ###########                            l
r                 #                            l
r       D X A     #                            l
r                 #                            l
r       ttttttttttt                            l
r                                              l
r                                              l
r                                              l
r                                              l
r                I                             l
r            p                                 l
r###############################################
;
Jump to reach the exits to worlds 'b' or 'c'.

§info
cell=I
message=Jump to reach the exits to worlds 'b' or 'c'.


§finish
cell=A
achievement=world_b
warp=b:welcome

§finish
cell=B
achievement=world_c
warp=c:welcome

§door
cell=D
open=1

§switch
cell=X
visible=0
toggle=0
on_script=close D
