
                                                                                  
  #   # #### #    ##  ##  ## ## ####   ###  ##     #  #  # ## ## ###  #  #   ##   
  #   # #  # #   #   #  # # # # #  #    #  #  #     # #  # # # # #  # ####   ##   
  # # # ###  #   #   #  # #   # ###     #  #  #     # #  # #   # ###     #        
  ## ##  ###  ##  ##  ##  #   #  ###    #   ##    ##   ##  #   # #    ###    ##   
                                                                                  
###############################################A #################################
#                                                                           f f  #
# p       H                                                                 f f  #
#######       ###########        ##############              #####################
      #########          ########              ###           #                    
                                                  ###        #                    
                                                     ###     #                    
                                                        ###  #                    
                                                           ###                    





                                     #   W     #
                                     #         #
                               I     k    Y    k
                                     k         k
tttttttttttttttttttttttttttttttttttttttttttttttttttttttttttttttttttttttttttttttttt

;
§diz
Welcome to Jumpy !

Reach the green chequer on the right end to complete this room.

§end


§wall
cell=A
semipermeable=1
color=#fff4f400
size=6;6

§finish
cell=Y-1.5;0
achievement=hook
message=Congratulations, you have unlocked the grappling hook !

§door
cell=W
vertical=0
open=`secret_welcome_hook

§info
cell=I
message=This door is openened elsewhere..;;Hint: Go down when down is up !

§info
cell=H-1.5;0
message=Welcome to Jumpy!;;Hint: Beware of red blocks and keep an eye out for secret passages!
