



############
#         ##
#         ##
#         ##
#         ##
#         ##
#         ##
#         ##
#         ##
#  k      ##
#yyyyyyyyy##
#         ##
#         ##
#         ##
#         ##
#         #################kk##kk##kk##kk##kk##kk##kk##kk##kk##kk########kk##kk##kk##kk##kk##kk##kk##kk##kk####
#         ###########                            A               ####B                                       ######
#                                   kkkk         U                           kkkk           kkkk             T  ####
#                                                                    S                                            ###
#  p                                                               ####                                     ##      #
##########                                                         ####                                     ##  f   #                   
         #############kkkkkkkkkkkkkkkkkkkkkkkkkkkkkkkkkkkkkkkkkkkkk####kkkkkkkkkkkkkkkkkkkkkkkkkkkkkkkkkkkkk#########
;
§global
player_gravity=-0.5

§switch
cell=S
trigger=0
toggle=false
on_script=player:gravity -0.6

§switch
cell=T
trigger=0
toggle=false
on_script=player:gravity 1

§switch
cell=U
trigger=0
toggle=false
on_script=player:gravity 1


§runner
cell=A
size=18;6
dirx=1
gravity=0.0
speed=1.0
mover=1

§runner    
cell=B     
size=18;6 
dirx=1     
gravity=0.0
speed=1.0  
mover=1   

§end 


                   
                   


