  #        #                                    
  #        #                                    
  #        #                                    
  #        #   #                     
  #        #  ###                                 
  #        # #####                                
  #   u    #   #                                  
  #        #   #                                  
  #        #                                      
  #        #####################                  
  #                            #                  
  #                   #        #                  
  #                  ###       #                  
  #                 #####      #                  
  #                   #        #                  
  #                   #        #                  
  #      yyyyyyyyyyyyyyyyyyyyyy#                  
  #      ##                    #                  
  #      ##                    #                  
  #      ##                    #                  
  #      ##yyyyyyyyyyyyyyyyyyyy#                  
  #      ##                    #                  
  #      ##                    #                  
  #      ##yyyyyyyy            #                  
  #      #####                 #                  
  #      ##                    #                  
  #s s s ##yyyyyyyyyyyyyyyyyyyy#                  
  #      ##                    #                  
  #      ##                    #                  
  #      ##           yyyyyyyyy#                  
  #      ##                 ####                  
  #m m m ##                 yyy#                  
  #      ##  yyyyyyy           #                  
  #   f  ##                    #                  
  #      ##      p             #                  
  ##############################                  
                                                  
                                                  
;
§diz
This room introduces semi-permeable floors
and stompable blocks that you can crash through
at certain falling speeds.

While falling down, press DOWN to accelerate.

Blue blocks can be passed at average falling speeds.

Red blocks can only be crashed through at high 
falling speeds. 

§end
