                                                                                          
                                                                                          
kkkkkkkkkkkkkkkkkkkkkkkkkkkkkkkkkkkkkkkkkkkkkkkkkkkkkkkkkkkkkkkkkkkkkkkkkkkkkkkkkkkkkkkkkk
#                                          k                                             #
#                                          k                                             #
#                                          k                                             #
#                                          k                                             #
#                                          k                                             #
#                                          k                                             #
#              kkkkkkkkkkkkkkkk            ############             k                    #
#                             k                                     k                    #
#                             k                                     k                    #
#                             k                                     k                    #
#kkkkkkk                      k                                     k                    #
#                             kkkkkkkkkkkkkkkkkkkkkkkkkkkkkkkkkkkkkkk####                #
#                                          k                                             #
#         kkkkkkkk                         k                                             #
#                                          k      f                                      #
#                                          k                                             #
#############kkkkkkkkkkkkkkkk              ###############################################
#                                          #                                              
#                                          #                                              
#                                          #                                              
#                          kkkkkkkkkkkkkkkk#                                              
#                                          #                                              
#                                          #                                              
#            #######                       #                                              
#      A                                   #                                              
#   p                                      #                                              
############################################                                              
;
§diz
Pilot your way to finish and do not touch the red blocks !
§end

§switch
cell=A
on_script=player:gravity -0.6,player:gravity_stompscale 0.6

§end

