#                                            #                                            
#                                            #                                            
#                  f                         #                                            
#                                            #                                            
#                                            #                                            
#                                            #                                            
#                                            #                                            
#                                            #                                            
#                                       ######                                            
#                                            #                                            
#                                            #                                            
#                                            #                                            
#                                            #                                            
#                    #####                   #                                            
#                    #####                   #                                            
#                    #####                   #                                            
#                    ######                  #                                            
#   p                ######                  #                                            
##############################################                                            
                                                                                          
;
§diz
Press UP to jump, and at the peak, just before you start to fall,
press UP again to gain some more height.

Floating and double-jumping are basically the same thing.
§end
