                                                                                          
                                                                                          
##########################################################################################
#                                                                                        #
#                                                                                        #
#                                                                                        #
#                                                                               f        #
#                                                                                        #
#                                                                                        #
#              ################            ############             ######################
#                                                                                        #
#                                                                                        #
#                                                                                        #
########                                                                                 #
#                                                                                        #
#                                                                                        #
#         ########                                                                       #
#                                                                                        #
#                                                                                        #
#############################              ###############################################
#                                          #                                              
#                                          #                                              
#                                          #                                              
#                          #################                                              
#                                          #                                              
#                                          #                                              
#            #######                       #                                              
#                                          #                                              
#   p                                      #                                              
############################################                                              
;
§diz
Make your way to the finish by jumping across platforms. 
Hold UP to jump higher.
§end
