                                                                                          
                                                                                          
##############################################                                            
#                      ###                   #                                            
#                      ###                   #                                            
#                      ###                   #                                            
#                      ###                   #                                            
#                      ###          f        #                                            
#                      ###                   #                                            
#                      ###                   #                                            
#  p                   ###                   #                                            
#                                            #                                            
##############################################                                            
                                                                                          
                                                                                          
                                                                                         
;
§diz
Float, then press DOWN to accelerate and fly through the passage.
§end

§global
player_gravity=-1
