############################################                                              
#         B                                #                                              
#                                          #                                              
#                                          #                                              
#                                          #                                              
#                                          #                                              
#   p  A                                   #                                              
############################################                                              
;
§diz
switch test

§switch
cell=A
visible=0
on_script=B:active 1, B:visible 1

§runner
cell=B
gravity=0.6
dirx=0
visible=0
active=0

