



############
#         ##
#         ##
#         ##
#         ##
#         ##
#         ##
#         ##
#         ##
#         ##
#yyyyyyyyy##
#         ##
#         ##
#         ##
#         ##
#         ##
#         ##
#         ##
#         ##
#  p      ##
############
;
§global
player_gravity=-0.5
