##############
#            #
#            #
#            #
#            #
#            #
#            #
#            #
#            #
#            #
#            #
#   A  p     #
#yyyyyyyyyyyy#
#            #
#            #
#            #
#            #
#            #
##############                                              
;
§diz
wall stomp fallthrough test

§switch
cell=A
on_script=player:gravity -1, A:visible 0
