############################################                                              
#         D       C                        #                                              
#         R                                #                                              
#                                          #                                              
#                             ##############                                              
#                             #                                              
#   p     A       B           #                                              
###############################                                              
;
§diz
runner path test

§runner
cell=R
gravity=0.0
dirx=0
diry=-1
turnaround=0

§switch
cell=A
visible=0
onlyrunners=1
toggle_script=R:dirx 1, R:diry 0

§switch
cell=B
visible=0
onlyrunners=1
toggle_script=R:dirx 0, R:diry 1

§switch
cell=C
visible=0
onlyrunners=1
toggle_script=R:dirx -1, R:diry 0

§switch
cell=D
visible=0
onlyrunners=1
toggle_script=R:dirx 0, R:diry -1

§sequencer
speed=96
step0=togglemover R
