#################
#               #
#               #
#               #
#         C     #
#yyyyyyyyyyyyyyy#
#               #
#         A     #
#   p           #
#################
;
§runner
cell=C
dirx=1
diry=0
gravity=0
speed=0.2


§switch
cell=A
on_script=C:dirx 0, C:diry 1
off_script=C:dirx 1, C:diry 0
 
