#############################
#                           #
#                           #
#                           #
#                           #
#                           #
#                           #
#                           #
#                           #
#                           #
#                           #
# p A         B             #
#yyyyyyyyyyyyyyyyyyyyyyyyyyy#



;

§switch
cell=A
toggle_script=rotatecw player

§runner
cell=B
dirx=1
gravity=0




