                                                                                          
                                                                                          
###########################################
#                   #                     #
#                   #                     #
#                   #                     #
#                   #                     #
#                   #  f    k             #
#                p  #       k             #
#              ##############             #
#                           #             #
#                           #             #
#                           #             #
#                           #             #
#yyyyyyyy                                 #
#                                         #
#                                         #
#                                         #
#                                         #
###########################################
;
§diz
debug


§end
